A	AH
A(2)	EY
ANIMAL	AE N AH M AH L
ARE	AA R
ARE(2)	ER
BIRTH	B ER TH
BIRTHDATE	B ER TH D EY T
BORN	B AO R N
BYE	B AY
DATE	D EY T
FAVORITE	F EY V ER IH T
FAVORITE(2)	F EY V R AH T
FROM	F R AH M
GOOD	G UH D
GOOD(2)	G IH D
GREAT	G R EY T
HOW	HH AW
IS	IH Z
MAGNET	M AE G N AH T
NEW	N UW
NEW(2)	N Y UW
OF	AH V
SING	S IH NG
SONG	S AO NG
STOP	S T AA P
SWEATER	S W EH T ER
WERE	W ER
WHAT	W AH T
WHAT(2)	HH W AH T
WHEN	W EH N
WHEN(2)	HH W EH N
WHEN(3)	W IH N
WHEN(4)	HH W IH N
WHERE	W EH R
WHERE(2)	HH W EH R
WHO	HH UW
YOU	Y UW
YOUR	Y AO R
YOUR(2)	Y UH R
